1 7 1 1 1 7 1 1 1 7 1 1 1 1 7 1 1 1 7 1 1 1 7 1
1 1 1 10 1 1 1 1 1 1 1 1 10 1 1 1 1 1 1 1 1 10 1 1
4 0 0 0 0 0 0 0 0 0 0 0 0 0 0 0 0 6 2 2 5 0 0 4
4 0 0 0 0 0 0 0 0 0 0 0 0 0 0 0 6 3 2 2 5 0 0 4
4 0 0 0 0 0 0 0 0 0 0 0 0 0 0 0 6 2 2 2 5 0 0 4
4 0 0 0 0 0 0 0 0 0 0 0 0 0 0 6 3 2 2 3 5 0 0 4
4 0 0 0 0 0 0 0 0 0 0 0 0 0 0 6 2 2 2 5 0 0 0 4
4 0 0 0 0 0 0 0 0 0 0 0 0 0 0 6 2 2 3 5 0 0 0 4
4 0 0 0 0 0 0 0 0 0 0 0 0 0 6 3 2 2 5 0 0 0 0 4
4 0 0 0 0 0 0 0 0 0 0 0 0 0 3 2 2 3 5 0 0 0 0 4
4 0 0 0 0 0 0 0 0 0 0 0 0 0 0 9 9 0 0 0 0 0 0 4
4 0 0 0 0 0 0 0 0 0 0 0 0 0 0 8 8 0 0 0 0 0 0 4
4 0 0 0 0 0 0 0 0 0 0 0 0 6 3 2 2 5 0 0 0 0 0 4
4 0 0 0 0 0 0 0 0 0 0 0 6 3 2 2 2 5 0 0 0 0 0 4
6 3 3 3 3 3 3 3 3 3 3 3 3 2 2 2 2 3 3 3 3 3 3 5
2 2 2 2 2 2 2 2 2 2 2 2 2 2 2 2 2 2 2 2 2 2 2 2 
2 2 2 2 2 2 2 2 2 2 2 2 2 2 2 2 2 2 2 2 2 2 2 2 
2 2 2 2 2 2 2 2 2 2 2 2 2 2 2 2 2 2 2 2 2 2 2 2 